1111111111111111
1P00000000C00001
111110C111111111
1111000C11111111
1000000000C00001
11111111111100C1
1E000000C000C001
1111111111111111
