111111111
10P01E101
1C0C11101
111111111
